1,3,2,1,5
1,1,1,1,5
2,2,2,1,4
1,1,1,1,4
5,5,1,1,1
