5,5,5,5,5
3,3,3,1,5
2,1,2,1,4
1,5,5,1,4
5,5,5,5,5
